NO ./sprites/forest.xpm
SO ./sprites/forest.xpm
WE ./sprites/forest.xpm
EA ./sprites/forest.xpm
M ./music/greenpath.mp3

D ./sprites/door.xpm
C ./sprites/sky.xpm
F ./sprites/grass.xpm
S2 ./sprites/plant2.xpm

S1 ./sprites/plant.xpm

1111111111111111111 1111111
111111111000000000111000001
101100000111000000001111111
100100000000000000000001111
100000000011000001111111111
111101111111110111000010001
111101111111110111010010001
110000001101010111000010001
1000000000000000D0000010001
10000222202000W011010010001
110000011101010111111110001
11110101 1110101 1111010001
11111111 1111111 1111111111

111
101
111