NO ./sprites/forest.xpm
SO ./sprites/forest.xpm
WE ./sprites/forest.xpm
EA ./sprites/forest.xpm

M ./music/greenpath.mp3
D ./sprites/door.xpm
S ./sprites/plant.xpm
F ./sprites/grass.xpm
C ./sprites/sky.xpm

       1111111111111111111 1111111
11111111100000000011000001 1000001
10110000011100000000000011 1111111
100100000000000000000000111111111
111111111011000001110000000000001
100000000011000001110111111111111
11110111111111011100000010001
11110111111111011101010010001
11000000110101011100000010001
10000000000W0000DD00000010001
10000000000000001101010010001
11000001110101011111011110001
11110101 1110101 101111010001
11111111 1111111 1111111111111